[
	{
		"id": "4a5e3742-d809-40b6-87e3-6dd055fd26b8",
		"width": 12,
		"height": 12,
		"styleMap": [
			"tile-blank",
			"tile-floor",
			"tile-wall",
			"tile-enemy",
			"tile-player"
		],
		"output": [
			4, 1, 1, 1, 1, 1, 1, 1, 1, 1, 1, 1, 1, 1, 1, 1, 1, 1, 2, 2, 2, 2, 2, 1, 1,
			1, 1, 1, 1, 1, 2, 3, 1, 1, 2, 1, 0, 1, 1, 1, 1, 1, 2, 1, 1, 5, 2, 1, 0, 0,
			1, 1, 1, 1, 2, 2, 1, 2, 2, 1, 0, 0, 0, 1, 1, 1, 1, 1, 1, 1, 1, 1, 0, 0, 0,
			0, 0, 1, 1, 1, 1, 1, 1, 1, 0, 0, 0, 0, 0, 0, 0, 0, 1, 1, 1, 1, 0, 0, 0, 0,
			0, 0, 0, 1, 1, 1, 0, 0, 0, 0, 0, 0, 0, 0, 1, 1, 1, 0, 0, 0, 0, 0, 0, 0, 0,
			1, 1, 1, 0, 0, 0, 0, 0, 0, 0, 0, 1, 1, 1, 1, 1, 1, 1, 1
		]
	},
	{
		"id": "1264bb15-ea79-4abd-b70b-9c60d438e06e",
		"width": 12,
		"height": 12,
		"styleMap": [
			"tile-blank",
			"tile-floor",
			"tile-wall",
			"tile-enemy",
			"tile-player"
		],
		"output": [
			4, 1, 1, 1, 1, 1, 1, 1, 1, 1, 1, 0, 1, 1, 1, 1, 1, 1, 1, 1, 1, 0, 0, 0, 0,
			1, 1, 1, 1, 1, 1, 1, 1, 0, 0, 0, 0, 0, 1, 1, 1, 1, 1, 1, 0, 0, 0, 0, 0, 0,
			1, 1, 1, 1, 1, 0, 0, 0, 0, 0, 0, 0, 1, 1, 1, 1, 1, 0, 0, 0, 0, 0, 1, 1, 1,
			1, 1, 1, 1, 0, 0, 0, 0, 0, 1, 2, 2, 1, 2, 2, 1, 0, 0, 0, 0, 0, 1, 2, 1, 1,
			1, 2, 1, 1, 0, 0, 0, 0, 1, 2, 1, 1, 3, 2, 1, 1, 1, 0, 0, 0, 1, 2, 2, 2, 2,
			2, 1, 1, 1, 1, 1, 0, 1, 1, 1, 1, 1, 1, 1, 1, 1, 1, 1, 1
		]
	},
	{
		"id": "1095f2f4-0fdb-4636-8b04-88a65ff8beff",
		"width": 12,
		"height": 12,
		"styleMap": [
			"tile-blank",
			"tile-floor",
			"tile-wall",
			"tile-enemy",
			"tile-player"
		],
		"output": [
			4, 1, 1, 1, 1, 1, 1, 1, 1, 1, 1, 0, 1, 1, 1, 1, 1, 1, 2, 2, 2, 2, 2, 0, 0,
			1, 1, 1, 1, 1, 2, 1, 1, 1, 2, 0, 0, 0, 1, 1, 1, 1, 2, 3, 1, 1, 2, 0, 0, 0,
			1, 1, 1, 1, 2, 2, 1, 2, 2, 0, 0, 0, 1, 1, 1, 1, 1, 1, 1, 1, 1, 0, 0, 0, 1,
			1, 1, 1, 1, 1, 1, 1, 0, 0, 0, 0, 0, 1, 1, 1, 1, 1, 0, 0, 0, 0, 0, 0, 0, 0,
			1, 1, 1, 1, 0, 0, 0, 0, 0, 0, 0, 1, 1, 1, 1, 1, 1, 0, 0, 0, 0, 0, 1, 1, 1,
			1, 1, 1, 1, 1, 1, 0, 0, 1, 1, 1, 1, 1, 1, 1, 1, 1, 1, 1
		]
	}
]
